##########################
#                        #
### ### ### ##### ##### ##
#                        #
## ######## ######## #####
## ########   ###### #####
##          @ ###### ## ##
## ########   ###### ## ##
## ################# ## ##
##                      ##
#################### #####
##########################

; Describe map details in section below
[details]
This is first detail.

This is second detail.
; Fancy comment
This is third detail
